
##############################################################################
#  ____                _ _          ____  _                                  #
# |  _ \ _ __ ___  ___(_) |_ __ _  / ___|| |_ __ _  __ _  ___                #
# | |_) | '__/ _ \/ __| | __/ _` | \___ \| __/ _` |/ _` |/ _ \               #
# |  __/| | |  __/ (__| | || (_| |  ___) | || (_| | (_| |  __/               #
# |_|   |_|  \___|\___|_|\__\__,_| |____/ \__\__,_|\__, |\___|               #
#                                                  |___/                     #
#----------------------------------------------------------------------------#
#                           Authorized access only!                          #
#         Disconnect IMMEDIATELY if you are not an authorized user!!!        #
#                All actions will be monitored and recorded.                 #
##############################################################################
